41,41,41,41,41,41,41,41,41,41,41,41,41,41,41,41,41,41,41,41,41,41,41,41,41
41,33,51,51,51,51,51,51,51,34,41,41,41,41,41,41,41,41,41,41,41,41,41,41,41
41,42,11,11,11,11,11,11,11,40,41,41,41,41,41,33,51,51,51,51,51,51,51,34,41
41,42,11,55,11,11,56,11,11,50,51,51,51,51,51,52,11,11,11,57,11,11,11,40,41
41,42,11,11,11,58,05,06,59,29,29,29,29,29,29,29,29,60,06,06,06,07,56,40,41
41,43,31,31,32,11,15,16,17,11,30,31,31,31,31,32,11,15,16,16,53,17,11,40,41
41,41,41,41,42,11,15,53,17,11,40,41,41,41,41,42,11,15,53,16,16,17,11,40,41
41,41,41,41,42,11,15,16,17,56,40,41,41,41,41,42,11,15,16,54,16,17,11,40,41
41,41,41,41,42,58,15,16,17,11,40,41,41,41,41,42,11,25,26,26,26,27,11,40,41
41,41,41,41,42,11,25,49,27,11,40,41,41,41,41,42,58,11,55,11,11,56,11,40,41
41,41,41,41,42,11,11,28,56,57,40,41,41,41,41,42,11,11,11,11,57,11,57,40,41
41,41,41,41,43,31,32,28,30,31,44,41,41,41,41,42,11,56,11,11,11,11,11,40,41
41,41,41,41,41,41,42,28,40,41,41,41,41,41,41,42,57,11,11,55,11,11,11,40,41
41,41,41,41,41,41,42,28,40,41,41,41,41,41,41,42,11,11,11,11,56,11,11,40,41
41,41,41,41,41,41,42,28,40,41,41,41,41,41,41,42,11,58,11,11,11,11,11,40,41
41,41,41,41,41,33,52,28,50,34,41,41,41,41,41,42,11,58,11,11,11,58,11,40,41
41,41,41,41,41,42,11,39,58,40,41,41,41,41,41,43,31,31,31,31,31,31,31,44,41
41,41,41,41,41,42,55,11,11,40,41,41,41,41,41,41,41,41,41,41,41,41,41,41,41
41,41,41,41,41,43,31,31,31,44,41,41,41,41,41,41,41,41,41,41,41,41,41,41,41
41,41,41,41,41,41,41,41,41,41,41,41,41,41,41,41,41,41,41,41,41,41,41,41,41

0,1,1,1,1,1,1,1,1,1,0,0,0,0,0,0,0,0,0,0,0,0,0,0,0
1,0,0,0,0,0,0,0,0,0,1,0,0,0,0,1,1,1,1,1,1,1,1,1,0
1,0,0,0,0,0,0,0,0,0,1,1,1,1,1,0,0,0,0,0,0,0,0,0,1
1,0,0,0,0,0,0,0,0,0,0,0,0,0,0,0,0,0,0,0,0,0,0,0,1
1,0,0,0,0,0,0,0,0,0,0,0,0,0,0,0,0,0,0,0,0,0,0,0,1
1,0,0,0,0,0,0,0,0,0,0,0,0,0,0,0,0,0,0,0,0,0,0,0,1
0,1,1,1,0,0,0,0,0,0,0,1,1,1,1,0,0,0,0,0,0,0,0,0,1
0,0,0,1,0,0,0,0,0,0,0,1,0,0,1,0,0,0,0,0,0,0,0,0,1
0,0,0,1,0,0,0,0,0,0,0,1,0,0,1,0,0,0,0,0,0,0,0,0,1
0,0,0,1,0,0,0,0,0,0,0,1,0,0,1,0,0,0,0,0,0,0,0,0,1
0,0,0,1,0,0,0,0,0,0,0,1,0,0,1,0,0,0,0,0,0,0,0,0,1
0,0,0,1,0,0,0,0,0,0,0,1,0,0,1,0,0,0,0,0,0,0,0,0,1
0,0,0,0,1,1,0,0,0,1,1,0,0,0,1,0,0,0,0,0,0,0,0,0,1
0,0,0,0,0,1,0,0,0,1,0,0,0,0,1,0,0,0,0,0,0,0,0,0,1
0,0,0,0,0,1,0,0,0,1,0,0,0,0,1,0,0,0,0,0,0,0,0,0,1
0,0,0,0,1,0,0,0,0,0,1,0,0,0,1,0,0,0,0,0,0,0,0,0,1
0,0,0,0,1,0,0,0,0,0,1,0,0,0,1,0,0,0,0,0,0,0,0,0,1
0,0,0,0,1,0,0,0,0,0,1,0,0,0,0,1,1,1,1,1,1,1,1,1,0
0,0,0,0,1,0,0,0,0,0,1,0,0,0,0,0,0,0,0,0,0,0,0,0,0
0,0,0,0,0,1,1,1,1,1,0,0,0,0,0,0,0,0,0,0,0,0,0,0,0