410,411,411,411,411,411,411,411,411,411,410,410,410,410,410,410,410,410,410,410,410,410,410,410,410
411,330,510,510,510,510,510,510,510,340,411,410,410,410,410,411,411,411,411,411,411,411,411,411,410
411,420,110,110,110,110,110,110,110,400,411,411,411,411,411,330,510,510,510,510,510,510,510,340,411
411,420,110,550,110,110,560,110,110,500,510,510,510,510,510,520,110,110,110,570,110,110,110,400,411
411,420,110,110,110,580,050,060,590,290,290,290,290,290,290,290,290,600,060,060,060,070,560,400,411
411,430,310,310,320,110,150,160,170,110,300,310,310,310,310,320,110,150,160,160,530,170,110,400,411
410,411,411,411,420,110,150,530,170,110,400,411,411,411,411,420,110,150,530,160,160,170,110,400,411
410,410,410,411,420,110,150,160,170,560,400,411,410,410,411,420,110,150,160,540,160,170,110,400,411
410,410,410,411,420,580,150,160,170,110,400,411,410,410,411,420,110,250,260,260,260,270,110,400,411
410,410,410,411,420,110,250,490,270,110,400,411,410,410,411,420,580,110,550,110,110,560,110,400,411
410,410,410,411,420,110,110,280,560,570,400,411,410,410,411,420,110,110,110,110,570,110,570,400,411
410,410,410,411,430,310,320,280,300,310,440,411,410,410,411,420,110,560,110,110,110,110,110,400,411
410,410,410,410,411,411,420,280,400,411,411,410,410,410,411,420,570,110,110,550,110,110,110,400,411
410,410,410,410,410,411,420,280,400,411,410,410,410,410,411,420,110,110,110,110,560,110,110,400,411
410,410,410,410,410,411,420,280,400,411,410,410,410,410,411,420,110,580,110,110,110,110,110,400,411
410,410,410,410,411,330,520,280,500,340,411,410,410,410,411,420,110,580,110,110,110,580,110,400,411
410,410,410,410,411,420,110,390,580,400,411,410,410,410,411,430,310,310,310,310,310,310,310,440,411
410,410,410,410,411,420,550,110,110,400,411,410,410,410,410,411,411,411,411,411,411,411,411,411,410
410,410,410,410,411,430,310,310,310,440,411,410,410,410,410,410,410,410,410,410,410,410,410,410,410
410,410,410,410,410,411,411,411,411,411,410,410,410,410,410,410,410,410,410,410,410,410,410,410,410