41,41,41,41,41,41,41,41,41,41,41,41,41,41,41,41,41,41,41,41,41,41,41,41,41
41,33,51,51,51,51,51,51,51,34,41,41,41,41,41,41,41,41,41,41,41,41,41,41,41
41,42,11,11,11,11,11,11,11,40,41,41,41,41,41,33,31,31,31,31,31,31,31,34,41
41,42,11,11,11,11,11,11,11,50,51,51,51,51,51,52,11,11,11,11,11,11,11,40,41
41,42,11,11,11,11,11,11,11,11,11,11,11,11,11,11,11,11,11,11,11,11,11,40,41
41,43,31,31,32,11,11,11,11,11,30,31,31,31,31,32,11,11,11,11,11,11,11,40,41
41,41,41,41,42,11,11,11,11,11,40,41,41,41,41,42,11,11,11,11,11,11,11,40,41
41,41,41,41,42,11,11,11,11,11,40,41,41,41,41,42,11,11,11,11,11,11,11,40,41
41,41,41,41,42,11,11,11,11,11,40,41,41,41,41,42,11,11,11,11,11,11,11,40,41
41,41,41,41,42,11,11,11,11,11,40,41,41,41,41,42,11,11,11,11,11,11,11,40,41
41,41,41,41,42,11,11,11,11,11,40,41,41,41,41,42,11,11,11,11,11,11,11,40,41
41,41,41,41,43,31,32,11,30,31,44,41,41,41,41,42,11,11,11,11,11,11,11,40,41
41,41,41,41,41,41,42,11,40,41,41,41,41,41,41,42,11,11,11,11,11,11,11,40,41
41,41,41,41,41,41,42,11,40,41,41,41,41,41,41,42,11,11,11,11,11,11,11,40,41
41,41,41,41,41,41,42,11,40,41,41,41,41,41,41,42,11,11,11,11,11,11,11,40,41
41,41,41,41,41,41,42,11,40,41,41,41,41,41,41,42,11,11,11,11,11,11,11,40,41
41,41,41,41,41,33,52,11,50,34,11,11,11,11,11,43,31,31,31,31,31,31,31,44,41
41,41,41,41,41,42,11,11,11,40,41,41,41,41,41,41,41,41,41,41,41,41,41,41,41
41,41,41,41,41,42,11,11,11,40,41,41,41,41,41,41,41,41,41,41,41,41,41,41,41
41,41,41,41,41,43,31,31,31,44,41,41,41,41,41,41,41,41,41,41,41,41,41,41,41